50
50
489,489,489,489,489,489,489,489,489,489,489,489,489,489,489,489,489,489,489,489,489,489,489,489,489,489,489,489,489,489,489,489,489,489,489,489,489,489,489,489,489,489,489,489,489,489,489,489,489,489,
489,7,2,9,489,489,489,489,489,489,489,489,489,489,489,489,489,489,489,489,489,489,489,489,489,489,489,489,489,489,489,489,489,489,489,489,489,489,371,422,372,489,489,489,489,489,489,489,489,489,
489,489,489,371,422,422,422,422,432,432,432,432,432,422,422,422,422,422,372,489,489,489,371,422,422,422,422,422,372,489,489,489,489,371,422,422,422,422,423,487,421,372,489,489,489,489,489,489,489,489,
489,489,371,423,487,487,487,487,487,487,487,487,487,487,487,487,487,487,421,422,422,422,423,487,487,487,487,487,421,422,422,422,422,423,487,487,487,487,487,487,487,421,372,489,489,489,489,489,489,489,
489,489,400,487,487,444,649,564,514,564,514,564,564,514,554,554,515,487,487,487,487,487,487,487,487,487,487,487,487,487,487,487,487,487,487,487,487,487,487,487,487,487,398,489,489,489,489,489,489,489,
489,489,400,487,487,467,214,48,48,48,48,48,48,48,48,48,553,514,514,514,514,515,487,487,487,487,487,487,487,444,557,446,487,487,487,487,487,487,487,487,487,487,398,489,489,489,489,489,489,489,
489,489,400,487,487,490,577,48,48,48,48,48,48,48,48,48,48,48,48,48,48,599,445,557,557,445,445,445,557,558,143,556,445,446,487,487,487,444,446,487,487,487,398,489,489,489,489,489,489,489,
489,489,400,487,487,487,650,120,121,48,48,48,48,48,48,48,48,48,48,48,48,165,166,166,166,166,166,166,166,166,309,143,143,556,445,557,557,558,469,487,487,487,421,372,489,489,489,489,489,489,
489,489,400,487,487,487,490,511,581,509,48,48,48,48,48,48,48,48,48,48,48,48,48,48,48,48,48,48,48,48,165,166,166,166,166,166,166,309,556,446,487,487,487,398,489,489,489,489,489,489,
489,489,369,377,487,487,487,487,487,532,48,48,48,48,48,48,48,48,48,48,48,48,48,48,48,48,48,48,48,48,48,48,48,48,48,48,48,165,309,556,445,446,487,421,372,489,489,489,489,489,
489,489,489,400,487,444,445,557,445,600,48,48,48,48,48,48,48,48,48,48,48,48,48,48,48,48,48,48,48,48,48,48,48,48,48,48,48,48,165,309,143,533,487,487,398,489,489,489,489,489,
489,371,422,487,487,490,512,145,123,260,48,48,48,48,48,48,48,48,48,48,48,48,48,48,48,48,48,48,48,48,48,48,48,48,48,48,48,48,48,142,143,556,446,487,398,489,489,489,489,489,
489,369,377,487,487,487,490,512,123,283,48,48,48,48,48,48,48,48,48,48,48,48,48,48,48,48,48,48,48,48,48,48,48,48,48,48,48,48,48,142,143,145,469,487,421,372,489,489,489,489,
489,489,400,487,487,487,487,490,512,283,48,48,48,48,48,48,48,48,48,48,48,48,48,48,48,48,48,48,48,48,48,48,48,48,48,48,48,48,48,142,169,145,533,487,487,398,489,489,489,489,
489,489,400,487,487,487,487,487,490,577,48,48,48,48,48,48,48,48,48,48,48,48,48,48,48,48,48,48,48,48,48,48,48,48,48,48,48,48,48,142,169,145,469,487,487,421,372,489,489,489,
489,489,400,487,487,487,487,487,487,536,48,48,48,48,48,48,48,48,48,48,48,48,48,48,48,48,48,48,48,48,48,48,48,48,48,48,48,48,48,142,169,145,533,487,487,487,398,489,489,489,
489,489,369,377,487,487,487,487,487,536,48,48,48,48,48,48,48,48,48,48,48,48,48,48,48,48,48,48,48,48,48,48,48,48,48,48,48,48,48,142,169,510,492,487,487,487,398,489,489,489,
489,489,489,400,487,487,487,487,487,536,48,48,48,48,48,48,48,48,48,48,48,48,48,48,48,48,48,48,48,48,48,48,48,48,48,48,48,48,119,310,169,469,487,487,487,487,398,489,489,489,
489,489,489,400,487,487,487,487,487,559,509,48,48,48,48,48,48,48,48,48,48,48,48,48,48,48,48,48,48,48,48,48,48,48,48,48,48,48,142,143,510,492,487,487,487,487,421,372,489,489,
489,489,489,400,487,487,487,487,487,487,532,48,48,48,48,48,48,48,48,48,48,48,48,48,48,48,48,48,48,48,48,48,48,48,48,48,48,48,142,510,492,487,487,487,487,487,487,398,489,489,
489,489,489,369,377,487,487,487,487,487,559,509,48,48,48,48,48,48,48,48,48,48,48,48,48,48,48,48,48,48,48,48,48,48,48,48,48,119,310,533,487,487,487,487,487,487,487,398,489,489,
489,489,489,489,400,487,487,487,487,487,487,532,48,48,48,48,48,48,48,48,48,48,48,48,48,48,48,48,48,48,48,48,48,48,48,48,48,165,309,533,487,487,487,487,487,487,487,398,489,489,
489,489,489,489,400,487,487,487,487,487,487,559,509,48,48,48,48,48,48,48,48,48,48,48,48,48,48,48,48,48,48,48,48,48,48,48,48,48,142,533,487,487,487,487,487,487,487,398,489,489,
489,489,489,489,400,487,487,487,487,487,487,487,536,48,48,48,48,48,48,48,48,48,48,48,48,48,48,48,48,48,48,48,48,48,48,48,48,48,142,556,446,487,487,487,487,487,487,398,489,489,
489,489,489,489,400,487,487,487,487,487,487,487,536,48,48,48,48,48,48,48,48,48,48,48,48,48,48,48,48,48,48,48,48,48,48,48,48,48,165,309,556,446,487,487,487,487,487,398,489,489,
489,489,489,489,369,377,487,487,487,487,487,487,536,48,48,48,48,48,48,48,48,48,48,48,48,48,48,48,48,48,48,48,48,48,48,48,48,48,48,142,143,556,446,487,487,487,487,398,489,489,
489,489,489,489,489,400,487,487,487,487,487,487,536,48,48,48,48,48,48,48,48,48,48,48,48,48,48,48,48,48,48,48,48,48,48,48,48,48,48,165,309,143,533,487,487,487,487,398,489,489,
489,489,489,489,489,400,487,487,487,487,487,444,600,48,48,48,48,48,48,48,48,48,48,48,48,48,48,48,48,48,48,48,48,48,48,48,48,48,48,48,165,309,533,487,487,487,487,398,489,489,
489,489,489,489,489,400,487,487,487,487,487,467,260,48,48,48,48,48,48,48,48,48,48,48,48,48,48,48,48,48,48,48,48,48,48,48,48,48,48,48,48,142,556,446,487,487,487,421,372,489,
489,489,489,489,489,400,487,487,487,487,444,558,283,48,48,48,48,48,48,48,48,48,48,48,48,48,48,48,48,48,48,48,48,48,48,48,48,48,48,48,48,142,143,556,446,487,487,487,398,489,
489,489,489,489,489,400,487,487,487,487,467,123,333,262,121,48,48,48,48,48,48,48,48,48,48,48,48,48,48,48,48,48,48,48,48,48,48,48,48,48,48,142,143,143,469,487,487,487,398,489,
489,489,489,489,489,400,487,487,487,444,558,143,123,168,333,308,213,48,48,48,48,48,48,48,48,48,48,48,48,48,48,48,48,48,48,48,48,119,120,120,120,310,510,491,492,487,487,375,370,489,
489,489,489,489,489,400,487,487,487,467,123,143,169,147,123,144,48,48,48,48,48,48,48,48,48,48,48,48,48,48,48,48,48,48,48,48,119,310,143,143,143,491,492,487,487,487,487,398,489,489,
489,489,489,489,489,400,487,487,487,490,512,169,143,169,147,333,120,121,48,48,48,48,48,48,48,48,48,48,48,48,48,48,48,48,48,48,142,143,510,491,492,487,487,487,487,487,487,398,489,489,
489,489,489,489,489,400,487,487,487,487,535,123,143,143,169,147,143,333,121,48,48,48,48,48,48,48,48,48,48,48,48,48,48,48,48,119,310,510,492,487,487,487,487,487,487,487,487,398,489,489,
489,489,489,489,489,400,487,487,487,487,490,512,123,147,169,143,143,145,144,48,48,48,48,48,48,48,48,48,48,48,48,48,48,48,48,142,143,469,487,487,487,487,487,487,487,487,375,370,489,489,
489,489,489,489,489,400,487,487,487,487,487,535,123,123,147,143,145,145,333,120,121,48,48,48,48,48,48,48,48,48,48,48,48,48,119,310,510,492,487,487,487,487,487,487,487,375,370,489,489,489,
489,489,489,489,489,400,487,487,487,487,487,535,169,123,169,169,123,169,145,145,333,262,262,262,262,262,262,262,121,48,48,48,119,120,310,510,492,487,487,487,487,487,487,487,487,370,489,489,489,489,
489,489,489,489,489,400,487,487,487,487,487,490,512,123,123,123,169,145,169,145,145,122,122,170,170,123,123,123,144,48,48,119,310,143,510,492,487,487,487,487,487,487,375,370,489,489,489,489,489,489,
489,489,489,489,489,400,487,487,487,487,487,487,490,512,510,511,491,511,512,145,169,169,122,170,170,123,122,123,333,120,120,310,143,510,492,487,487,487,487,487,487,487,370,489,489,489,489,489,489,489,
489,489,489,489,489,369,377,487,487,487,487,487,487,490,492,487,487,487,490,511,512,169,168,168,168,123,123,123,510,491,491,491,491,492,487,487,487,487,487,487,487,398,489,489,489,489,489,489,489,489,
489,489,489,489,489,489,369,377,487,487,487,487,487,487,487,487,487,487,487,487,490,512,169,122,145,510,491,491,492,487,487,487,487,487,487,487,487,487,487,487,487,398,489,489,489,489,489,489,489,489,
489,489,489,489,489,489,489,369,377,487,487,487,487,487,487,487,487,487,487,487,487,490,512,145,510,492,487,487,487,487,487,487,487,487,487,487,487,487,487,487,375,370,489,489,489,489,489,489,489,489,
489,489,489,489,489,489,489,489,369,376,376,377,487,487,487,487,487,487,487,487,487,487,490,491,492,487,487,487,487,487,487,487,487,487,487,487,487,487,487,375,370,489,489,489,489,489,489,489,489,489,
489,489,489,489,489,489,489,489,489,489,489,369,376,376,376,377,487,487,487,487,487,487,487,487,487,487,487,487,487,487,487,487,487,487,487,487,487,375,376,370,489,489,489,489,489,489,489,489,489,489,
489,489,489,489,489,489,489,489,489,489,489,489,489,489,489,369,376,376,376,377,487,487,487,487,487,487,487,487,487,487,487,487,487,375,376,376,376,370,489,489,489,489,489,489,489,489,489,489,489,489,
489,489,489,489,489,489,489,489,489,489,489,489,489,489,489,489,489,489,489,369,376,376,376,376,376,376,376,376,376,376,376,376,376,370,489,489,489,489,489,489,489,489,489,489,489,489,489,489,489,489,
489,489,489,489,489,489,489,489,489,489,489,489,489,489,489,489,489,489,489,489,489,489,489,489,489,489,489,489,489,489,489,489,489,489,489,489,489,489,489,489,489,489,489,489,489,489,489,489,489,489,
489,489,489,489,489,489,489,489,489,489,489,489,489,489,489,489,489,489,489,489,489,489,489,489,489,489,489,489,489,489,489,489,489,489,489,489,489,489,489,489,489,489,489,489,489,489,489,489,489,489,
489,489,489,489,489,489,489,489,489,489,489,489,489,489,489,489,489,489,489,489,489,489,489,489,489,489,489,489,489,489,489,489,489,489,489,489,489,489,489,489,489,489,489,489,489,489,489,489,489,489

